R      1920      1080
NO ./path_to_the_north_texture
WE ./path_to_the_west_texture
EA ./path_to_the_east_texture

S path_to_the_sprite_texture.bmp

F 220,145, 30
C 225,255,255
SO ./path_to_the_south_texture

        111111111 111111111111111
        1 1000001 110000000000001
        111100001 110000002000001
        100100001 100000000000001
11111111101100001 110000000000001
10000000001100001 110111111111111
11110111111111011 1100000010001
1111011111111101111101010010001
11000000110101011 1100000010001
100020000000N0001 1100000010001
10000000000000001 101101010010011
1100000111010101111101111000111
11110111 11101011 101111010001
11111111 11111111 111 111111111111
