R 320 200

NO ./path_to_the_north_texture
SO ./path_to_the_south_texture
WE ./path_to_the_west_texture
EA ./path_to_the_east_texture

S path_to_the_sprite_texture.bmp

F 220, 145, 30
C 225, 30, 0

11111111
10000001
10000011
10S00001
10000001
10000001
10000001
11111111
