R      2540    2000
SO ./texture/harlock_drinking.xpm
NO ./texture/nausica_harlock.xpm
EA ./texture/harlock_personnage.xpm
WE ./texture/harlock_rafflesia.xpm

S ./sprite/harlock_arcadia_transparent.xpm

F 220,145, 30
C 220,255,255

        111111111 111111111111111
        1 1000001 110000000000001
        111100001 11000000000000111
        100100001 100001110000000001
11111111101100001 110001 10000000001
10000000001100001 11011111111111111
1111011111111101111100000010001
1111011111111100000001010010001
1110000000110101111100000000001
10000000000000001 1100000010001
10002000W00000001 101101010010011
1100200000010101111101111000111
11110111111101011 1011110110001
11111111 11111111 111 111111111111
