R  1920 1080

NO ./path_to_the_north_texture
SO ./path_to_the_south_texture
WE ./path_to_the_west_texture
EA ./path_to_the_east_texture

S path_to_the_sprite_texture.bmp

F 220, 145, 30
C 225, 30, 0

        1111111111 111111111111111
        1 1000001 110000011000001
111111111111111111110000100111111
111111111111111111100000001
11111111111111111100000000011111
        1111000011110000002000001
        1001000000000000000000001
111111111011000011110001111
10000000001100001 110111111111111
11110111111111011 1100000010001
111111111111111111101111111111
11110111111111011 1101010010001
1100000011010101111100000010001
10002000E00000000000000000010001
100000000000000011101101010010011
11000001110101011 1101111000111
11110111 11101011 101111010001
1111111 11111111 111 111111111111
