R      2560      1440
SO ./texture/harlock_drinking.xpm
NO ./texture/nausica_harlock.xpm
EA ./texture/harlock_personnage.xpm
WE ./texture/harlock_rafflesia.xpm

S ./sprite/harlock_arcadia_transparent.xpm

F 220,145, 30
C 225,255,255

        111111111 111111111111111
        1 1000001 110000000000001
        111100001 110000002000001
        120100001 100000000000001
11111111101100001 110000000000001
10000002001100001 110111111111111
1111011111111101111100000010001
1111011111111100000001010010201
1100000011010101111100000000001
10002000000000001 1100000010001
100000000N0000001 101101010010011
1100000111010101111101111000111
11110111 11101011 101111010001
11111111 11111111 111 111111111111
